11111111111111111111111111111
10000000000000000000000000001
10E00000010000000000000000101
10000000001000000111111100001
10000000110000011100000100001
10000100000000000101110100101
10001110000011110100010100001
10000100000010010111110101001
10000001000010010000000100001
10000000000011111110111100001
10001010000000000000100000001
10001110000010000000100111001
10001100000111100000111100001
10000000000000000000000000001
11111111111111111111111111111
