NO ./img/BRICK_3B.xpm
SO ./img/BRICK_3D.xpm
WE ./img/TILE_1A.xpm
EA ./img/TILE_2C.xpm

F 20,30,50
C 135,206,235

11111111111111111111
10000000000000000001
10000000000000000001
10001010101010101001
10000000000000000001
10000000000000001001
10000000000000001001
10000000000000001001
10000000000001111001
10000000000000000001
10000000000000000001
10000000000000000001
11111111111111111111
