C 255,0,0
WE ./img/TILE_1A.xpm
EA ./img/TILE_2C.xpm
NO ./img/BRICK_3B.xpm
SO ./img/BRICK_3D.xpm

F 255,255,255





11111111111111111111
10000000000000000001
10000000000000000001
100E1010101010101001
10000000000000000001
10000000000000001001
10000000000000001001
10000000000000001001
10000000000001111001
10000000000000000001
10000000000000000001
10000000000000000001
11111111111111111111
