NO ./img/BRICK_3B.xpm
SO ./img/BRICK_3D.xpm
WE ./img/TILE_1A.xpm
EA ./img/TILE_2C.xpm

F 220,100,0
C 225,30,0

11111111111111111111111111111111111111111111111111111111111111111111111111111111111111
100000000000000000000000000000E0000001000000000000000000010000000000000100000000000001
10000000000000000000000000000000000001000000000000000000010000000000000100000000000001
10000000000000000000000000000000000000000000000000000000000000000000000000000000000001
11111111111111111111111111111111111111111111111111111111111111111111111111111111111111
