NO ./img/BRICK_3B.xpm
SO ./img/BRICK_3D.xpm
WE ./img/TILE_1A.xpm
EA ./img/TILE_2C.xpm

F 221,221,221
C 100,148,237

11111111111111111111
10000000000000000011
10110110000000010101
10100100100100010101
1E000000000000010001
11111100100010010111
10000100011100100011
10010000000001000111
10010110000010010001
11111111111111111111
