NO ./img/BRICK_3B.PNG
SO ./img/BRICK_3D.PNG
WE ./img/TILE_1A.PNG
EA ./img/TILE_2C.PNG

F 220,100,0
C 225,30,0

111111111111111111111111111111
1W1000100100011000011111111111
100110100010000000100110000001
101000101010111100100000011101
101011001010010001011000110001
100010010000110100010100111101
101011001010110111110100010101
101010101010000100010101000001
100000101001111000100101111111
111110101011111110100100000101
100000101010000000000010101101
101111101010111111111100101101
100000001000000000100000101101
111111111111100100100011101101
100000000000001110001000000001
111111111111111111111111111111