NO ./img/BRICK_3B.xpm
SO ./img/BRICK_3D.xpm
WE ./img/TILE_1A.xpm
EA ./img/TILE_2C.xpm

F 220,100,0
C 225,30,0

11111111111111111111111111111111111111111111111
10000000000000000001001000000001000000001000011
10110110000000011111111111001010000001010010101
1010010010010001         1111010010001010010101
1000100011111111         1001000000001000010001
110001001                1001001001001011010111
1111110011111111         1111111111110001100011
1000000101110001                   110001000011
1001110000000111                   100011010111
1011000111111111         1011111111110001100011
10111101                 1100011000100011010111
1001010111111111         1101011000100010010111
1N000001000010011111111111001000001001000100001
10000000000000000000000000000000000000000000001
11111111111111111111111111111111111111111111111