NO ./img/BRICK_3B.PNG
SO ./img/BRICK_3D.PNG
WE ./img/TILE_1A.PNG
EA ./img/TILE_2C.PNG

F 220,100,0
C 225,30,0

1111111111111111111111111111111111
1E00000000000000000000000000000001
1111111111111111111111111111111111