NO ./img/BRICK_3B.xpm
SO ./img/BRICK_3D.xpm
WE ./img/TILE_1A.xpm
EA ./img/TILE_2C.xpm

F 220,100,0
C 225,30,0

1111111111111111111111111111111111
1E00000000000000000000000000000001
1111111111111111111111111111111111